{
    "Ã": "A",
    "Â": "A",
    "Á": "A",
    "ã": "a",
    "â": "a",
    "á": "a",
    "à": "a",
    "É": "E",
    "Ê": "E",
    "È": "E",
    "é": "e",
    "ê": "e",
    "è": "e",
    "Í": "I",
    "Î": "I",
    "Ì": "I",
    "î": "I",
    "í": "i",
    "ì": "i",
    "Ô": "O",
    "Õ": "O",
    "Ó": "O",
    "Ò": "O",
    "ô": "o",
    "õ": "o",
    "ó": "o",
    "ò": "o",
    "Ú": "U",
    "Ù": "U",
    "ú": "u",
    "ù": "u",
    "ç": "c"
}